A
ABETZ, Peter 	Liberal Party 	Southern River
ABRAHAM, Corina 	Socialist Alliance 	Willagee
AITKEN, Linda 	Liberal Party 	Butler
ALBAN, Frank 	Liberal Party 	Swan Hills
ALBREY, Ryan 	Flux The System! 	Kimberley
ALCHIN, Mark 	Liberal Party 	Pilbara
ALMOND, Annette 	WESTERN AUSTRALIA PARTY 	Carine
ANDERSON, Brigit 	Animal Justice Party 	Belmont
ARCHIBALD, David 	Pauline Hanson's One Nation 	Pilbara
ARNOLD, Adrian 	WESTERN AUSTRALIA PARTY 	Bateman
AUBREY, Rebecca 	Liberal Party 	Willagee
AYRE, Andrew 	Micro Business Party 	Fremantle
B
BAILEY, Dan 	Micro Business Party 	Scarborough
BAKER, Lisa 	WA Labor 	Maylands
BALDOCK, Michael 	The Greens (WA) 	Bunbury
BALLINGALL, Ben 	Flux The System! 	Perth
BALLINGER, Craig 	Micro Business Party 	Darling Range
BARAIOLO, Sandy 	Pauline Hanson's One Nation 	Thornlie
BARKER, Chris 	Flux The System! 	Darling Range
BARNETT, Colin 	Liberal Party 	Cottesloe
BATSIOUDIS, Paul 	Micro Business Party 	Mandurah
BAUMANN, Wendy 	Liberal Party 	Rockingham
BENNETT, Jenny 	Pauline Hanson's One Nation 	Forrestfield
BENNETT, Sibel 	Micro Business Party 	Thornlie
BEZUIDENHOUT, Rozane 	Pauline Hanson's One Nation 	Cannington
BHOWANIAH, Danusha 	WESTERN AUSTRALIA PARTY 	Swan Hills
BIGGS, Matthew 	The Greens (WA) 	Midland
BILTOFT, John 	Micro Business Party 	Midland
BIVOLTSIS, Jim 	Independent 	Churchlands
BLAYNEY, Ian 	Liberal Party 	Geraldton
BLEVIN, Ian 	Shooters, Fishers and Farmers 	Belmont
BLUNDELL-CAMDEN, Aeron 	The Greens (WA) 	Dawesville
BOKSMATI, Nasim 	Micro Business Party 	Morley
BOLAND, Greg 	The Greens (WA) 	Cottesloe
BOLTON, Richard 	Pauline Hanson's One Nation 	Kalgoorlie
BOSKAMP, Iwan 	The Greens (WA) 	Darling Range
BOSWELL, Marion 	WA Labor 	Riverton
BOWYER, Murray 	WESTERN AUSTRALIA PARTY 	Kalamunda
BRIGHTMAN, Brian 	Independent 	Joondalup
BRITZA, Ian 	Liberal Party 	Morley
BROGAN, Mark 	The Greens (WA) 	South Perth
BROWN, Paul 	THE NATIONALS 	Geraldton
BROWN, Samuel Jewell 	Pauline Hanson's One Nation 	Bunbury
BRUNING, Derek 	Australian Christians 	Darling Range
BUCHANAN, Craig 	Independent 	Rockingham
BURNSIDE, Gilbert Graeme 	Australian Christians 	Kingsley
BURWOOD, Callum 	The Greens (WA) 	Murray-Wellington
BUTI, Tony 	WA Labor 	Armadale
C
CAIN, Jillian 	The Greens (WA) 	Warnbro
CAREY, John 	WA Labor 	Perth
CARRIE-WILSON, Seb 	Flux The System! 	Mandurah
CATANIA, Vince 	THE NATIONALS 	North West Central
CAUDWELL, David 	Shooters, Fishers and Farmers 	Geraldton
CHANG, Tshung-Hui 	Pauline Hanson's One Nation 	Riverton
CHAPMAN, Graham 	Independent 	Kimberley
CHARLES, Mark 	Micro Business Party 	Rockingham
CHEN, Lily 	Liberal Party 	Mirrabooka
CLARKE, Robyn 	WA Labor 	Murray-Wellington
COALES, Rob 	Liberal Party 	Thornlie
COLLINS, Caitlin 	WA Labor 	Cottesloe
COLYVAS, Evazelia 	Micro Business Party 	Kalamunda
CONNOLLY, Paul 	The Greens (WA) 	Geraldton
COOK, Roger 	WA Labor 	Kwinana
COOPER, Mark 	The Greens (WA) 	Burns Beach
COWPER, Murray 	Liberal Party 	Murray-Wellington
COX, Dorinda 	The Greens (WA) 	Jandakot
CRABTREE, Bill 	Liberal Party 	Central Wheatbelt
CROOK, Brett 	Australian Christians 	Forrestfield
CROOK, Tony 	THE NATIONALS 	Kalgoorlie
CROUS, Rudolph Johannes 	Australian Christians 	Burns Beach
CULLITY, Judith 	The Greens (WA) 	Scarborough
CULUM-BUZAK, Sandy 	Micro Business Party 	Burns Beach
D
DALTON, Lara 	WA Labor 	Geraldton
D'ANGELO, Tony 	Pauline Hanson's One Nation 	Midland
DARCY, Joseph Laurence 	Pauline Hanson's One Nation 	Wanneroo
DAVIES, Mia 	THE NATIONALS 	Central Wheatbelt
DAVIES, Sandy 	Independent 	North West Central
DAY, John 	Liberal Party 	Kalamunda
D'CUNHA, Adrian 	Flux The System! 	North West Central
DEAS, Marc 	Shooters, Fishers and Farmers 	Warren-Blackwood
DEL POPOLO, Aldo 	Micro Business Party 	Bunbury
DICKMANN, Louise 	The Greens (WA) 	Bicton
DODD, Margaret 	Pauline Hanson's One Nation 	Scarborough
DOOBREE, Sareeta 	Micro Business Party 	Mirrabooka
DRENNAN, Joy 	Family First 	Burns Beach
DUFFY, Warren 	Pauline Hanson's One Nation 	Fremantle
DUNN, Mark A 	Flux The System! 	Pilbara
E
ERWIN, James 	Flux The System! 	Kalgoorlie
EVANGEL, Eleni 	Liberal Party 	Perth
F
FARRER, Josie 	WA Labor 	Kimberley
FARSALAS, Alexandra 	Micro Business Party 	Mount Lawley
FEGEBANK, Christine 	The Greens (WA) 	Baldivis
FELS, Tony 	(No Party Designation) 	Roe
FENSOME, Benny 	Micro Business Party 	Maylands
FIGGINS, Samantha 	Micro Business Party 	Warnbro
FISHLOCK, David L 	Liberal Democrats 	Southern River
FITZGERALD, Tomas 	WA Labor 	Bateman
FLAHERTY, Edward 	Micro Business Party 	Armadale
FOLKARD, Mark 	WA Labor 	Burns Beach
FOOTE, Audrey 	The Greens (WA) 	Central Wheatbelt
FORSTER, Darren 	WA Labor 	Kalgoorlie
FRANCIS, Joe 	Liberal Party 	Jandakot
FRANCIS, M 	Independent 	South Perth
FRASER, Sue 	Australian Christians 	Belmont
FREEMAN, Janine 	WA Labor 	Mirrabooka
FREEMAN, Jody 	The Greens (WA) 	Kwinana
FROUMIS, Manamal M 	Independent 	Darling Range
G
GARBER, Jack 	WESTERN AUSTRALIA PARTY 	Churchlands
GEORGE, Malcolm 	Liberal Party 	Baldivis
GILL, Daljeet 	Micro Business Party 	Churchlands
GILLETT, Paul 	THE NATIONALS 	Murray-Wellington
GINBEY, Keith 	Micro Business Party 	Nedlands
GOBBERT, Francesca 	Animal Justice Party 	Jandakot
GODFREY, Glenys 	Liberal Party 	Belmont
GOIRAN, Madeleine 	Australian Christians 	Thornlie
GOM, Estelle 	Independent 	Central Wheatbelt
GORDON, Peter 	THE NATIONALS 	Vasse
GOULD, Ray 	Pauline Hanson's One Nation 	Kalamunda
GREATOREX, Warren 	Liberal Party 	Kimberley
GREEN, Carol 	The Greens (WA) 	North West Central
GRIFFITHS, Anthony 	Pauline Hanson's One Nation 	Albany
GROENEWALD, Riaan 	Australian Christians 	Cottesloe
GROSSO, Daniel 	The Greens (WA) 	Nedlands
GRYLLS, Brendon 	THE NATIONALS 	Pilbara
GURAK, Joanna 	The Greens (WA) 	Churchlands
H
HALL, Greg 	Australian Christians 	Geraldton
HAMERSLEY, Craig 	Independent 	Baldivis
HAMILTON, Emily 	WA Labor 	Joondalup
HAMMOND, Gary 	Shooters, Fishers and Farmers 	Thornlie
HANSON, Matt 	Animal Justice Party 	Perth
HARLEY, Craig 	Independent 	Southern River
HART, Nicholas 	Family First 	Joondalup
HARTLEY, Wes 	WA Labor 	Vasse
HARVERSON, Elysia 	Liberal Party 	Collie-Preston
HARVEY, Liza 	Liberal Party 	Scarborough
HARVEY, Nicole 	The Greens (WA) 	Balcatta
HATTON, Chris 	Liberal Party 	Balcatta
HAYWARD, James 	THE NATIONALS 	Bunbury
HEALY, Terry 	WA Labor 	Southern River
HENDERSON, Rod 	Liberal Party 	West Swan
HEWITT, Shannon 	The Greens (WA) 	Cockburn
HILL, Shane 	WA Labor 	North West Central
HODDINOTT, Susan 	Pauline Hanson's One Nation 	Butler
HOLMES, Yvette 	Australian Christians 	Baldivis
HOOPER, Angela 	Micro Business Party 	North West Central
HOOPER, Davyd Cameron 	Micro Business Party 	Pilbara
HOSKING, Robin 	Australian Christians 	Willagee
HOST, Kevin 	Australian Christians 	Scarborough
HOST, Lois 	Australian Christians 	Morley
HOST, Rex 	Australian Christians 	Joondalup
HOUSTON, Rob 	THE NATIONALS 	Kimberley
HUGGINS, Don 	Australian Christians 	Bateman
HUGHES, Matthew 	WA Labor 	Kalamunda
HUNTER, Thomas 	WESTERN AUSTRALIA PARTY 	Warnbro
HUNTLEY, Andrew 	The Greens (WA) 	Warren-Blackwood
HUYNH, Cameron 	Independent 	Armadale
HYDE, Archie 	Micro Business Party 	Perth
HYDE, Joshua 	Micro Business Party 	Kwinana
HYLAND, Don 	Independent 	Collie-Preston
I
IGBOKWE, Chukwudumebi Sydney 	Australian Christians 	Mirrabooka
ISMAIL, Rafeif 	The Greens (WA) 	Mirrabooka
J
JACOB, Albert 	Liberal Party 	Burns Beach
JACOBS, Graham 	Liberal Party 	Roe
JACOBS, Jesse 	Liberal Party 	Cannington
JACOBS, Julian 	Liberal Party 	Victoria Park
JAGO, Ashley 	Animal Justice Party 	Forrestfield
JEFFERY, Wendy 	Liberal Party 	Armadale
JENKINS, Chris 	Socialist Alliance 	Fremantle
JOHNSON, Rob 	Independent 	Hillarys
JOHNSTON, Bill 	WA Labor 	Cannington
JONES, Kai 	Independent 	Kimberley
JOUBERT, Ryno Frederick 	Australian Christians 	Butler
K
KATSAMBANIS, Peter 	Liberal Party 	Hillarys
KELLY, Cathie 	Australian Christians 	Roe
KELLY, Dave 	WA Labor 	Bassendean
KELLY, James Joseph 	Pauline Hanson's One Nation 	Moore
KEPERT, Steve 	Independent 	Bicton
KERR, Thor 	The Greens (WA) 	Riverton
KHADKA, Bhuwan 	The Greens (WA) 	Belmont
KINGSFORD, Deonne 	Australian Christians 	Warnbro
KIRKUP, Zak 	Liberal Party 	Dawesville
KLEYN, Matt 	Australian Christians 	Maylands
KNAPP, Janetia 	WESTERN AUSTRALIA PARTY 	Fremantle
KORFANTY, Richard 	Micro Business Party 	Bicton
KRCOSKI, Dame 	Liberal Party 	Girrawheen
KRSTICEVIC, Tony 	Liberal Party 	Carine
L
LANCEE, Alida 	Independent 	Cottesloe
LAWRENCE, James 	WESTERN AUSTRALIA PARTY 	West Swan
LEAM, Peter 	The Greens (WA) 	Moore
L'ESTRANGE, Sean 	Liberal Party 	Churchlands
LILBURNE, Paul 	WA Labor 	Churchlands
LIM, Ken Ivan 	Australian Christians 	Perth
LITSON, Hugh 	WA Labor 	Warren-Blackwood
LLOYD, Louahna 	The Greens (WA) 	Hillarys
LOGAN, Fran 	WA Labor 	Cockburn
LONGO, Paul 	Shooters, Fishers and Farmers 	Morley
LOVE, Shane 	THE NATIONALS 	Moore
LUCAS, Mike 	Shooters, Fishers and Farmers 	Kalgoorlie
LUKE, Matueny Marial 	Independent 	Mirrabooka
M
MACPHERSON, Greg 	WESTERN AUSTRALIA PARTY 	Wanneroo
MADDEN, Amanda 	Liberal Party 	Maylands
MADDOX, Carl 	WESTERN AUSTRALIA PARTY 	Burns Beach
MAKKAR, Prabhpreet Singh 	Micro Business Party 	Baldivis
MALLOY, Aaron 	WESTERN AUSTRALIA PARTY 	Joondalup
MALOV, Dmitry 	Independent 	Cottesloe
MANGANO, Andrew 	WESTERN AUSTRALIA PARTY 	Nedlands
MARMION, Bill 	Liberal Party 	Nedlands
MARSHALL, Eugene 	The Greens (WA) 	Forrestfield
MARTIN, Graeme 	Micro Business Party 	Bassendean
MARTIN, Peter 	Micro Business Party 	Joondalup
MARTIN, Wayne 	Pauline Hanson's One Nation 	Geraldton
MASIH, Jonathan 	Micro Business Party 	Bateman
MASTERS, Bernie 	Shooters, Fishers and Farmers 	Bunbury
McALEESE, Donna 	The Greens (WA) 	Thornlie
McCALL, Mark 	Shooters, Fishers and Farmers 	Murray-Wellington
McCARTHY, Russell 	Shooters, Fishers and Farmers 	Dawesville
MCCOULL, Jake Adkins 	Liberal Democrats 	Darling Range
McENCROE, Keith John 	Australian Christians 	Balcatta
McGEORGE, Felicity 	The Greens (WA) 	Willagee
McGOWAN, Mark 	WA Labor 	Rockingham
McGRATH, John 	Liberal Party 	South Perth
McGURK, Simone 	WA Labor 	Fremantle
McHUGH, Connor 	Micro Business Party 	Cockburn
MCINNES, Simone 	The Greens (WA) 	Roe
McKENNA, Brent 	The Greens (WA) 	Pilbara
McMULLAN, Beth 	The Greens (WA) 	West Swan
McNAIR, John 	WESTERN AUSTRALIA PARTY 	Kingsley
METTAM, Libby 	Liberal Party 	Vasse
MEWHOR, Paul William 	Australian Christians 	Bassendean
MEYERS, Michelle 	Pauline Hanson's One Nation 	Bateman
MICHAEL, David 	WA Labor 	Balcatta
MICHEL, Kevin 	WA Labor 	Pilbara
MILES, Lee-Anne 	The Greens (WA) 	Kalamunda
MILES, Paul 	Liberal Party 	Wanneroo
MILLER, David 	Pauline Hanson's One Nation 	Collie-Preston
MILLIGAN, Hannah 	The Greens (WA) 	Perth
MILLMAN, Simon 	WA Labor 	Mount Lawley
MITCHELL, Andrea 	Liberal Party 	Kingsley
MITCHELL, Julie 	Pauline Hanson's One Nation 	Belmont
MOFFAT, Jodie 	The Greens (WA) 	Mandurah
MOLYNEUX, Ian 	WESTERN AUSTRALIA PARTY 	Perth
MORAN, Isaac 	Australian Christians 	West Swan
MORAN, Ray 	Australian Christians 	Carine
MOREL, Eleanor Charmaine 	Australian Christians 	Kwinana
MORISON, Ian 	Liberal Party 	Bunbury
MORONEY, Greg 	Pauline Hanson's One Nation 	Warren-Blackwood
MORTON, Nathan 	Liberal Party 	Forrestfield
MUBARAK, Kim 	Independent 	Mirrabooka
MUBARAKAI, Yaz 	WA Labor 	Jandakot
MUMME, James 	The Greens (WA) 	Rockingham
MURPHY, John Manfred 	Pauline Hanson's One Nation 	Jandakot
MURRAY, Mick 	WA Labor 	Collie-Preston
MUSCEDERE, Luke 	Liberal Party 	Warnbro
N
NAHAN, Mike 	Liberal Party 	Riverton
NAIDU, Nitasha 	Australian Christians 	Armadale
NALDER, Dean 	Liberal Party 	Bateman
NASTESKI, Mile 	Micro Business Party 	Balcatta
NGUYEN, Che Tam 	Family First 	Girrawheen
NORBERGER, Jan 	Liberal Party 	Joondalup
NORTON, Barni 	WA Labor 	Moore
NOYE, Jennifer 	Micro Business Party 	Victoria Park
O
O'CONNELL, Luke 	The Greens (WA) 	Vasse
O'DONNELL, Kyran 	Liberal Party 	Kalgoorlie
OLD, Sandra 	Pauline Hanson's One Nation 	Swan Hills
OMALLEY, James 	Pauline Hanson's One Nation 	Rockingham
O'MALLEY, Lisa 	WA Labor 	Bicton
OSTLE, Stuart W 	Shooters, Fishers and Farmers 	Darling Range
OWENS, Andrew 	WA Labor 	Carine
P
PAPALIA, Paul 	WA Labor 	Warnbro
PARASILITI, Daniel 	Liberal Party 	Midland
PASHA, Zeeshan 	Micro Business Party 	Riverton
PASS, Linley Anne 	Australian Christians 	Wanneroo
PASSMORE, Trent 	Shooters, Fishers and Farmers 	Midland
PEASE, Dennis 	Australian Christians 	Central Wheatbelt
PERKS, Caroline 	The Greens (WA) 	Maylands
PHILLIPS, David 	Australian Christians 	Girrawheen
PHILLIPS, Paul 	Australian Christians 	Churchlands
PIKOS-SALLIE, Toni 	The Greens (WA) 	Southern River
PILKINGTON, Luke 	THE NATIONALS 	Dawesville
POLGAR, Sharon 	Pauline Hanson's One Nation 	Darling Range
POPHAM, Terry 	Pauline Hanson's One Nation 	Carine
POPPAS, Nicole 	Micro Business Party 	Cottesloe
PORTELLI, Steve 	Independent 	Cockburn
PORTER, Wes 	Australian Christians 	Moore
POTTER, Paul John 	Micro Business Party 	Willagee
PRICE, Stephen 	WA Labor 	Forrestfield
PUNCH, Don 	WA Labor 	Bunbury
PYLE, Anthony 	The Greens (WA) 	Armadale
PYNT, Steven 	WESTERN AUSTRALIA PARTY 	Scarborough
Q
QUIGLEY, John 	WA Labor 	Butler
QUINN, Ryan 	The Greens (WA) 	Victoria Park
QUINTON, Sarah 	The Greens (WA) 	Bassendean
QUIRK, Margaret 	WA Labor 	Girrawheen
R
RADLEY, Daniel 	Flux The System! 	Murray-Wellington
RAJA-YOGAM, Lavin 	Liberal Party 	Cockburn
RASTRICK, David 	The Greens (WA) 	Albany
REDMAN, Terry 	THE NATIONALS 	Warren-Blackwood
REEVES-HENNESSEY, Nadine 	The Greens (WA) 	Carine
REGNARD, Susan 	Australian Christians 	Riverton
REID, Fiona 	Independent 	South Perth
REID, Shaun 	Pauline Hanson's One Nation 	Central Wheatbelt
REVIAN, Kandi 	Animal Justice Party 	Mount Lawley
REYNDERS, Diff 	Shooters, Fishers and Farmers 	Central Wheatbelt
RICCIARDI, Anne-Marie 	The Greens (WA) 	Morley
RIHANI, Zena 	Micro Business Party 	Cannington
RITCHIE, Teresa 	WA Labor 	Hillarys
ROACH, Raymond 	Shooters, Fishers and Farmers 	Girrawheen
ROBERTS, Matt 	The Greens (WA) 	Mount Lawley
ROBERTS, Michelle 	WA Labor 	Midland
ROBINSON, Elisabete 	Australian Christians 	Hillarys
ROOSE, Edward 	Australian Christians 	Cockburn
ROSENGRAVE, Peter W 	Micro Business Party 	Wanneroo
ROSS, Greg 	WESTERN AUSTRALIA PARTY 	Midland
ROWE, Cassie 	WA Labor 	Belmont
ROWLANDS, Lynne 	Liberal Party 	Mandurah
RUNDLE, Peter 	THE NATIONALS 	Roe
RUWOLDT, Trevor 	Shooters, Fishers and Farmers 	West Swan
S
SAFFIOTI, Rita 	WA Labor 	West Swan
SAMRA, Sat 	Micro Business Party 	Jandakot
SANDERSON, Amber-Jade 	WA Labor 	Morley
SAPORITA, Colleen 	Animal Justice Party 	Bicton
SCHOLZ, Alexander J 	Pauline Hanson's One Nation 	Warnbro
SCHUMACHER, Dave 	Independent 	Dawesville
SCIBILIA, Louie 	Independent 	Collie-Preston
SECKER, Steven 	Independent 	Southern River
SETH, Jim 	Liberal Party 	Bassendean
SHAH, Mushfiq 	The Greens (WA) 	Girrawheen
SHAHALAM, M 	Micro Business Party 	Forrestfield
SHANNON, Anthony G 	Flux The System! 	Bunbury
SHAVE, Lawrence 	Pauline Hanson's One Nation 	Dawesville
SHAW, Christopher 	Australian Christians 	Nedlands
SHAW, Doug 	Pauline Hanson's One Nation 	Mandurah
SHAW, Jessica 	WA Labor 	Swan Hills
SHENTON, Hayden 	Liberal Party 	Fremantle
SIMPSON, Tony 	Liberal Party 	Darling Range
SINGH, Aman 	Micro Business Party 	Southern River
SINGH, Lucky 	Micro Business Party 	Swan Hills
SINGH, Sahaj 	Micro Business Party 	Girrawheen
SLATER, Ross 	Pauline Hanson's One Nation 	Murray-Wellington
SLYNS, Darren 	Liberal Party 	Moore
SMITH, Gary 	Australian Christians 	Cannington
SMITH, Greg 	WESTERN AUSTRALIA PARTY 	Maylands
SMITH, Ron 	WESTERN AUSTRALIA PARTY 	Butler
SOBOH, Miral 	Micro Business Party 	Belmont
SOMMER, Ola 	Micro Business Party 	Butler
SORENSEN, Dane 	Pauline Hanson's One Nation 	North West Central
SPENCE, Liam 	Flux The System! 	Dawesville
SPENCER, Martin 	The Greens (WA) 	Fremantle
SPURLING, Jacqueline 	The Greens (WA) 	Kalgoorlie
SPYKER, Warnar 	Australian Christians 	Jandakot
SRIVASTAVA, Ash 	WESTERN AUSTRALIA PARTY 	Southern River
ST MARTIN, Jason Brett 	Micro Business Party 	South Perth
STACEY, Peter 	Shooters, Fishers and Farmers 	Roe
STAER, Mark Rohan 	Australian Christians 	Victoria Park
STALTARI, Dominic 	Micro Business Party 	Kingsley
STANFIELD, Erinn 	Flux The System! 	Cockburn
STEINECK, Rosemary Frances Capon 	Australian Christians 	South Perth
STOCKS, Greg 	Liberal Party 	Albany
STOJKOVSKI, Jessica 	WA Labor 	Kingsley
STONEHOUSE, Sylvia 	Australian Christians 	Rockingham
SUMMERS, Kath 	Independent 	Baldivis
SUTHERLAND, Michael 	Liberal Party 	Mount Lawley
SUTTON, Robert 	THE NATIONALS 	Albany
SVILICIC, Alan 	Micro Business Party 	Dawesville
'
't HART, Ian 	Australian Christians 	Albany
T
TAIT, Richard 	Liberal Democrats 	Balcatta
TALBOT, Bianca 	Liberal Party 	Kwinana
TALLENTIRE, Chris 	WA Labor 	Thornlie
TANTI, Victor 	Independent 	Geraldton
TAYLER, Gordon 	The Greens (WA) 	Collie-Preston
TAYLOR, Matt 	Liberal Party 	Bicton
TAYLOR, Penny 	WA Labor 	Nedlands
TAYLOR, Tim 	Pauline Hanson's One Nation 	Kwinana
TEMPLEMAN, David 	WA Labor 	Mandurah
TEMPLEMAN, Gary 	WA Labor 	Central Wheatbelt
THOMAS, Clinton 	Shooters, Fishers and Farmers 	Collie-Preston
THOMPSON, Elliot 	The Greens (WA) 	Cannington
TINLEY, Peter 	WA Labor 	Willagee
TREACY, Robyn 	The Greens (WA) 	Wanneroo
TSIRIGOTIS, Athan 	Micro Business Party 	Carine
TURNER, Jason 	THE NATIONALS 	Mandurah
U
URBAN, Barry 	WA Labor 	Darling Range
V
VAN BURGEL, Janelle 	Australian Christians 	Mount Lawley
VAN DAM, Andrew 	Flux The System! 	Thornlie
v
van der LINDE, Gabrielle 	Australian Christians 	Fremantle
V
VAN NIEKERK, Jan 	Shooters, Fishers and Farmers 	Butler
VAUGHAN, Liz 	The Greens (WA) 	Kimberley
VIRK, Mohsin 	(No Party Designation) 	Cannington
VOROS, Michael 	WA Labor 	South Perth
W
WALKER, Tony 	WA Labor 	Scarborough
WARD, Matthew 	The Greens (WA) 	Kingsley
WARDELL-JOHNSON, Stephen 	Australian Christians 	Bicton
WARNOCK, Monique 	THE NATIONALS 	Collie-Preston
WATSON, Michael 	(No Party Designation) 	Cottesloe
WATSON, Peter 	WA Labor 	Albany
WAUGH, Gavin 	WESTERN AUSTRALIA PARTY 	Riverton
WEBB, Evan 	The Greens (WA) 	Swan Hills
WEBB, Lisa 	The Greens (WA) 	Joondalup
WEBSTER, Tom 	The Greens (WA) 	Butler
WESTCOTT, Julee 	Liberal Party 	North West Central
WHITBY, Reece 	WA Labor 	Baldivis
WHITE-HARTIG, Fiona 	Shooters, Fishers and Farmers 	Pilbara
WHITFIELD, Matt 	Independent 	Baldivis
WILLIAMS, Brady John 	Australian Christians 	Kalamunda
WILLIAMSON, Ross 	Shooters, Fishers and Farmers 	Moore
WILLIS, Bradley 	WA Labor 	Roe
WILMOT, Adie 	The Greens (WA) 	Bateman
WILSON, Max 	Independent 	Wanneroo
WINTON, Sabine 	WA Labor 	Wanneroo
WOODAGE, Adam 	WA Labor 	Dawesville
WOODHOUSE, Ross 	Liberal Party 	Warren-Blackwood
WRIGHT, Keith David 	Pauline Hanson's One Nation 	Kimberley
WYATT, Ben 	WA Labor 	Victoria Park
Z
ZACKLOVA, Eketerina 	Pauline Hanson's One Nation 	Roe
ZURAKOWSKI, John Carl 	Pauline Hanson's One Nation 	Baldivis
